Key terms:
Nervous system - The system responsible for controlling the body and comprehending external stimuli
Central nervous system - Brain, brain stem and spine
Peripheral nervous system - The nervous system outide of the CNS
Somatic nervous system - Consisting of the motor and sensory nervous systems,
Autonomic nervous system - Consisting of the sympathetic and parasympathetic nervous systems,
Endocrine system - The system responsible for the production of hormones
Gland - An organ (?) that secretes hormones
Hormones - Chemicals which control the activity of internal bodily functions
Fight or flight response - The increase of heart rate and 
Adrenaline - A hormone responsible for the fight or flight response, incresaes arousal
Neuron - Cells which conduct electrical charge across the body to revieve and send information 
Sensory neurons - 
Relay neurons - 
Motor neurons - 
Localisation of function - The study of where in the brain certain functions are located
Motor area - Area responsible for movement
Somatosensory area - Area responsible for comprehending touch 
Visual area - Area responsible for processing visual information
Auditory area - Area responsible for producing, processing and understanding sound
Broca's area - Responsible for speech production
Wernicke's area - Responsible for speech comprehension 
Plasticity - The brains ability to adapt and 
Functional recovery - Positive plasticity and repair to damage 
Hemispheric lateralisation - 
Split-brain research - Research into the function of the left and right side of the brain, 
fMRI - 
EEG - 
ERPs - 
Post-mortem examination - The examination of a participantss brain after death
Biological rhythms - Rhyhtms that control bodily functions
Circadian rhythm - A rhythm that lasts 24 hours (sleep/wake cycle)
Infradian rhythm - A rhythm that lasts less than 24 hours 
Ultradian rhyhtm - A rhythm that lasts more than 24 hours
Endogenous pacemakers - Internal pacemakers (superchiasmatic nucleus)
Exogenous pacemakers - External cues which affect the bodies internal clock (sunlight, temperature)
Sleep/wake cycle - A circadian rhythm that controls when we sleep and wake up


